WXXTTTZTTT
TTTTXTTTTT
TT1TTTTXTT
TTTXTTTTTT
T1TXTTXTTT
TXTTTZTXXT
TXTTXTTTTT